State,Age,Year,Total,Male,Female,European-American/White,African-American/Black,Hispanic/Latino,Other
Alabama,0-4,804,294357,149715,144642,164954,85741,26453,11406
Alabama,5-9,804,297968,152011,145957,170291,85236,25594,11291
Alabama,10-14,804,310498,158134,152364,180184,89867,24976,10770
Alabama,15-19,804,313615,159086,154529,185866,93559,19918,10485
Alabama,20-24,804,322092,161393,160699,193027,99024,15848,10981
Alabama,25-29,804,338138,168634,169504,204250,104953,15702,10483
Alabama,30-34,804,309091,151231,157860,191460,89612,16896,9170
Alabama,35-39,804,304145,147221,156924,190183,85025,17310,9848
Alabama,40-44,804,289161,139359,149802,185031,78570,15106,8905
Alabama,45-49,804,308951,149462,159489,206933,78688,12566,9296
Alabama,50-54,804,307665,149245,158420,211694,76870,9568,8197
Alabama,55-59,804,336320,161384,174936,235967,83328,7674,7869
Alabama,60-64,804,321347,151491,169856,228031,79353,5575,6956
Alabama,65-69,804,275448,127347,148101,201010,63971,3576,5699
Alabama,70-74,804,225999,103186,122813,174849,43502,2534,4192
Alabama,75-79,804,155814,68081,87733,124141,26744,1619,2642
Alabama,80-84,804,101033,41215,59818,80674,17343,1105,1514
Alabama,85+,804,91543,31322,60221,72283,16389,1258,1207
Alaska,0-4,348,51080,26153,24927,25009,1730,5675,15640
Alaska,5-9,348,51596,26401,25195,24833,1520,5516,16641
Alaska,10-14,348,49066,25403,23663,23984,1393,4381,16266
Alaska,15-19,348,45110,23594,21516,22082,1488,3837,15164
Alaska,20-24,348,51283,29380,21903,26669,2595,5278,14720
Alaska,25-29,348,60427,32458,27969,33850,2599,5341,16579
Alaska,30-34,348,57161,30047,27114,33820,2099,4853,14612
Alaska,35-39,348,52421,27318,25103,32427,1956,4151,12392
Alaska,40-44,348,43344,22647,20697,27158,1478,3150,10415
Alaska,45-49,348,42303,22090,20213,27415,1401,2625,9916
Alaska,50-54,348,42827,22408,20419,28321,1326,2310,10092
Alaska,55-59,348,48222,25142,23080,33418,1433,2023,10579
Alaska,60-64,348,45117,22928,22189,32713,1203,1542,8959
Alaska,65-69,348,36261,18630,17631,26933,914,1053,6857
Alaska,70-74,348,25039,12877,12162,18864,474,684,4715
Alaska,75-79,348,15078,7521,7557,11445,257,364,2847
Alaska,80-84,348,8029,3680,4349,5859,185,219,1685
Alaska,85+,348,7181,2741,4440,5278,139,210,1439
Arizona,0-4,180,429788,219514,210274,161588,21258,196263,41595
Arizona,5-9,180,453692,231321,222371,174153,23428,198987,47437
Arizona,10-14,180,477053,243003,234050,185308,23336,212102,47539
Arizona,15-19,180,478065,244571,233494,194177,23132,206727,46188
Arizona,20-24,180,495482,256544,238938,207415,25647,204496,50452
Arizona,25-29,180,525879,273506,252373,234284,29973,200091,54791
Arizona,30-34,180,481214,249307,231907,228276,26922,170484,50791
Arizona,35-39,180,466981,238274,228707,228688,24393,162997,46646
Arizona,40-44,180,429046,215707,213339,213089,21560,149169,41606
Arizona,45-49,180,433343,215623,217720,233889,20534,136492,39413
Arizona,50-54,180,418747,206821,211926,244989,18803,118384,34052
Arizona,55-59,180,446731,216401,230330,290862,18472,102421,32482
Arizona,60-64,180,434063,204344,229719,305704,16110,82074,28062
Arizona,65-69,180,398499,184643,213856,299376,12319,61674,23330
Arizona,70-74,180,353200,165978,187222,281362,8557,44956,17056
Arizona,75-79,180,252667,117487,135180,206435,5396,29007,10970
Arizona,80-84,180,158530,73649,84881,129344,3236,18324,7162
Arizona,85+,180,145737,60604,85133,120751,2701,15942,5936
Arkansas,0-4,900,188464,96655,91809,115892,33916,24333,10058
Arkansas,5-9,900,192747,98863,93884,120562,33963,24712,9474
Arkansas,10-14,900,200466,102418,98048,126431,35326,25773,9314
Arkansas,15-19,900,197251,101079,96172,128082,35297,22497,8504
Arkansas,20-24,900,200287,101749,98538,131364,37301,20074,8955
Arkansas,25-29,900,205499,103759,101740,137673,37462,18760,9566
Arkansas,30-34,900,191369,95549,95820,132079,31728,17247,8706
Arkansas,35-39,900,192156,95917,96239,134041,30894,17614,8329
Arkansas,40-44,900,178107,88297,89810,126263,27952,15952,6789
Arkansas,45-49,900,182264,89510,92754,135059,26228,13945,6075
Arkansas,50-54,900,179318,88464,90854,135822,25828,11299,5421
Arkansas,55-59,900,198021,96194,101827,155207,28114,8411,5268
Arkansas,60-64,900,187973,89624,98349,149171,26744,6190,4821
Arkansas,65-69,900,164960,77149,87811,134615,21687,3906,3894
Arkansas,70-74,900,137869,63926,73943,117872,13808,2570,2896
Arkansas,75-79,900,98087,43981,54106,86048,8277,1455,1727
Arkansas,80-84,900,63054,26924,36130,55483,5177,960,1058
Arkansas,85+,900,59912,21558,38354,52184,5507,933,970
California,0-4,696,2383716,1220085,1163631,629854,118543,1217205,354908
California,5-9,696,2478850,1266874,1211976,626535,126194,1299761,364501
California,10-14,696,2529137,1292852,1236285,629172,127411,1339500,375751
California,15-19,696,2533694,1292178,1241516,674824,134268,1286271,385618
California,20-24,696,2647279,1359751,1287528,748520,155274,1283092,410927
California,25-29,696,3094978,1600681,1494297,957939,197677,1348684,543121
California,30-34,696,2957974,1525571,1432403,991327,177066,1191076,558864
California,35-39,696,2780574,1416586,1363988,938870,152447,1132150,522620
California,40-44,696,2501526,1255993,1245533,827913,137195,1035898,473283
California,45-49,696,2515419,1252341,1263078,884178,140641,987855,477835
California,50-54,696,2464326,1228030,1236296,973928,149879,888027,430173
California,55-59,696,2508777,1232488,1276289,1139962,159966,761324,425588
California,60-64,696,2277858,1099031,1178827,1125556,140051,601314,392300
California,65-69,696,1889872,887346,1002526,1001307,105586,433421,335668
California,70-74,696,1496798,689389,807409,852423,76233,302109,255734
California,75-79,696,1017681,453052,564629,589730,52737,198172,170316
California,80-84,696,683918,292317,391601,389400,36364,133885,120018
California,85+,696,749846,280289,469557,442310,33831,135136,133372
Colorado,0-4,768,332201,169135,163066,184755,14737,104299,20688
Colorado,5-9,768,346783,177399,169384,193918,15615,108111,21337
Colorado,10-14,768,363539,186072,177467,202305,15644,116397,21619
Colorado,15-19,768,365448,188223,177225,209027,15293,111776,22451
Colorado,20-24,768,377765,198011,179754,225094,17362,104048,24508
Colorado,25-29,768,461160,241879,219281,296114,22846,107617,28495
Colorado,30-34,768,452194,236587,215607,299655,20438,99466,27968
Colorado,35-39,768,425517,219924,205593,282822,18096,95674,24687
Colorado,40-44,768,372554,190873,181681,247934,15419,84950,20948
Colorado,45-49,768,365235,187290,177945,251283,15325,75502,20278
Colorado,50-54,768,340915,171232,169683,245856,13887,62492,16486
Colorado,55-59,768,364977,178883,186094,279180,13798,54756,15150
Colorado,60-64,768,348036,169065,178971,278061,12185,43433,12601
Colorado,65-69,768,296296,141759,154537,243483,8866,32359,10269
Colorado,70-74,768,225835,107827,118008,188828,5647,23122,7331
Colorado,75-79,768,141798,65343,76455,118428,3710,14711,4486
Colorado,80-84,768,88562,38497,50065,73039,2500,9788,2928
Colorado,85+,768,89921,33349,56572,76321,2155,8403,2759
Connecticut,0-4,96,181710,93028,88682,93972,20799,49551,13733
Connecticut,5-9,96,194738,99449,95289,101930,22985,50882,14979
Connecticut,10-14,96,214262,108848,105414,116231,24516,53650,15693
Connecticut,15-19,96,238872,121596,117276,141243,26401,50800,16549
Connecticut,20-24,96,239931,123103,116828,142877,28440,49067,16314
Connecticut,25-29,96,225457,116859,108598,125842,30755,48394,18063
Connecticut,30-34,96,222572,111988,110584,128382,27363,46360,18631
Connecticut,35-39,96,219855,108595,111260,128613,25198,46656,17741
Connecticut,40-44,96,207286,101260,106026,122692,24077,43701,15370
Connecticut,45-49,96,225494,109195,116299,146209,24724,38190,15029
Connecticut,50-54,96,251411,121619,129792,178236,25647,33912,12464
Connecticut,55-59,96,267967,129472,138495,203099,24736,28348,10669
Connecticut,60-64,96,245488,118403,127085,194692,20369,20923,8583
Connecticut,65-69,96,195083,92056,103027,158674,14503,14536,6748
Connecticut,70-74,96,157736,72164,85572,130300,11043,10768,5152
Connecticut,75-79,96,112284,49799,62485,93989,7723,6828,3443
Connecticut,80-84,96,73811,30609,43202,62340,4967,4399,1920
Connecticut,85+,96,91330,31374,59956,80802,4588,3990,1734
Delaware,0-4,36,54719,27536,27183,26144,13368,9685,4073
Delaware,5-9,36,56312,28682,27630,27016,14457,9179,4124
Delaware,10-14,36,57663,29049,28614,27776,14889,9589,3803
Delaware,15-19,36,60218,30426,29792,31124,15631,8442,3597
Delaware,20-24,36,57154,28976,28178,29702,15909,6972,3499
Delaware,25-29,36,65311,33022,32289,36108,16854,6939,4542
Delaware,30-34,36,63769,31721,32048,37101,14329,6927,4754
Delaware,35-39,36,59374,29316,30058,33384,13590,7358,4486
Delaware,40-44,36,53727,26045,27682,30394,12652,6605,3586
Delaware,45-49,36,56685,27246,29439,34064,13480,5642,3080
Delaware,50-54,36,62196,29625,32571,39832,14378,4728,2855
Delaware,55-59,36,69315,32798,36517,47998,14772,3466,2708
Delaware,60-64,36,68415,31800,36615,50136,12811,2728,2422
Delaware,65-69,36,61422,28232,33190,47345,9899,1957,1983
Delaware,70-74,36,51436,23780,27656,40797,7459,1348,1656
Delaware,75-79,36,34652,15640,19012,27788,4859,790,1092
Delaware,80-84,36,21142,9301,11841,17044,2822,470,747
Delaware,85+,36,20254,7598,12656,16596,2499,566,536
District of Columbia,0-4,12,45368,23092,22276,14126,19791,7815,2559
District of Columbia,5-9,12,38177,19507,18670,8143,20549,6923,1772
District of Columbia,10-14,12,29221,14614,14607,5423,17415,4763,1120
District of Columbia,15-19,12,36571,17400,19171,11315,18078,4644,1938
District of Columbia,20-24,12,51397,22967,28430,20494,21109,5191,3799
District of Columbia,25-29,12,82514,38036,44478,38741,28760,8234,5694
District of Columbia,30-34,12,82027,39281,42746,41500,24591,8817,6061
District of Columbia,35-39,12,63808,31056,32752,29890,20950,7717,4524
District of Columbia,40-44,12,45161,22366,22795,18302,17294,5902,3193
District of Columbia,45-49,12,38462,19288,19174,13721,17246,4830,2321
District of Columbia,50-54,12,35824,17846,17978,12136,17989,3785,1608
District of Columbia,55-59,12,36628,18062,18566,10992,20759,3312,1270
District of Columbia,60-64,12,33248,15458,17790,9599,19599,2675,1145
District of Columbia,65-69,12,28255,12251,16004,9082,16130,1821,991
District of Columbia,70-74,12,21964,9382,12582,8120,11778,1273,635
District of Columbia,75-79,12,15010,6121,8889,5607,8072,776,469
District of Columbia,80-84,12,9872,3880,5992,3105,5928,521,269
District of Columbia,85+,12,12242,4104,8138,4104,7252,478,339
Florida,0-4,804,1139742,582738,557004,464205,224875,374382,53022
Florida,5-9,804,1166350,596090,570260,472545,236219,377465,57086
Florida,10-14,804,1206047,614949,591098,502435,240309,383010,59139
Florida,15-19,804,1202436,614664,587772,515983,237278,375383,56165
Florida,20-24,804,1258122,642134,615988,554147,249611,379357,59027
Florida,25-29,804,1419816,724144,695672,651589,283461,406057,64697
Florida,30-34,804,1379606,699679,679927,636209,248345,420908,63278
Florida,35-39,804,1336741,666425,670316,606020,230281,428576,62346
Florida,40-44,804,1263790,624191,639599,566039,206619,423731,59039
Florida,45-49,804,1340417,658894,681523,655459,205172,412705,59257
Florida,50-54,804,1368978,669084,699894,735452,197820,375905,52896
Florida,55-59,804,1489510,715912,773598,887790,201159,343268,50246
Florida,60-64,804,1408845,659081,749764,913161,179807,264312,45415
Florida,65-69,804,1295884,595312,700572,893835,141043,215652,40514
Florida,70-74,804,1169485,541247,628238,861225,102368,170680,31526
Florida,75-79,804,870367,398693,471674,651961,66843,128915,20276
Florida,80-84,804,580147,259548,320599,428183,44147,93967,12452
Florida,85+,804,581454,234271,347183,440447,39906,89587,10042
Georgia,0-4,1908,656566,334896,321670,280282,218702,102722,41013
Georgia,5-9,1908,685587,348924,336663,291964,229105,106206,44132
Georgia,10-14,1908,727416,370338,357078,315745,246799,108158,43799
Georgia,15-19,1908,732120,371833,360287,333469,250226,95851,42194
Georgia,20-24,1908,717380,364423,352957,335163,250710,82180,40415
Georgia,25-29,1908,771584,386644,384940,360218,279615,78115,45742
Georgia,30-34,1908,721677,354987,366690,347318,243480,77886,46649
Georgia,35-39,1908,709018,342876,366142,338861,233830,83425,47452
Georgia,40-44,1908,671936,322933,349003,326581,218082,78982,43634
Georgia,45-49,1908,712696,344386,368310,373675,223030,68879,42812
Georgia,50-54,1908,686956,334205,352751,381837,213311,54228,34231
Georgia,55-59,1908,691407,332248,359159,408383,210348,39289,30199
Georgia,60-64,1908,616126,290080,326046,380368,179676,27735,25731
Georgia,65-69,1908,511367,233277,278090,331008,140379,17622,20233
Georgia,70-74,1908,414634,187674,226960,288756,98147,11577,14540
Georgia,75-79,1908,273561,120360,153201,197453,58572,7133,9356
Georgia,80-84,1908,166323,68648,97675,121050,34781,4350,5504
Georgia,85+,1908,151069,51692,99377,111227,30656,4386,4138
Hawaii,0-4,60,85219,43782,41437,14200,2022,17119,38705
Hawaii,5-9,60,86710,44660,42050,13386,1620,18744,40495
Hawaii,10-14,60,80876,41389,39487,10324,1310,12760,44326
Hawaii,15-19,60,77287,39985,37302,10239,1259,11286,43325
Hawaii,20-24,60,88650,48667,39983,20184,3259,13105,42153
Hawaii,25-29,60,101864,53750,48114,22708,3849,13716,51259
Hawaii,30-34,60,98131,50374,47757,22849,3036,11990,51150
Hawaii,35-39,60,96871,49150,47721,22387,2585,11501,51393
Hawaii,40-44,60,84932,42941,41991,17945,1822,8797,48642
Hawaii,45-49,60,84135,42385,41750,16985,1586,7223,51113
Hawaii,50-54,60,83612,41444,42168,17681,1382,5965,51693
Hawaii,55-59,60,89958,44458,45500,21489,1242,5664,54668
Hawaii,60-64,60,89179,43442,45737,23852,981,4585,53754
Hawaii,65-69,60,83038,40057,42981,24808,714,3394,49105
Hawaii,70-74,60,69054,33121,35933,21285,557,2302,41064
Hawaii,75-79,60,45499,21119,24380,12389,247,1445,28765
Hawaii,80-84,60,29189,12326,16863,6770,159,750,19942
Hawaii,85+,60,41668,14990,26678,7141,150,518,32105
Idaho,0-4,528,116200,59300,56900,85432,1141,21908,5420
Idaho,5-9,528,123317,62782,60535,91372,1214,23163,5338
Idaho,10-14,528,131471,67341,64130,98788,1158,24369,5100
Idaho,15-19,528,125185,63779,61406,94905,1245,21785,5481
Idaho,20-24,528,116434,61044,55390,87965,1349,20216,5265
Idaho,25-29,528,121631,62849,58782,93511,1451,19655,5568
Idaho,30-34,528,114859,57868,56991,90141,1081,17250,5343
Idaho,35-39,528,118233,59717,58516,94875,1138,16627,4606
Idaho,40-44,528,108939,55203,53736,88951,722,14222,4201
Idaho,45-49,528,102792,52115,50677,85034,712,12365,3959
Idaho,50-54,528,98974,49687,49287,83772,608,10550,3405
Idaho,55-59,528,109541,53672,55869,95926,549,8949,3520
Idaho,60-64,528,108819,52697,56122,97910,539,6603,3195
Idaho,65-69,528,97884,47661,50223,89646,328,4752,2641
Idaho,70-74,528,77982,38329,39653,72446,178,3084,1924
Idaho,75-79,528,52941,25118,27823,49444,90,1991,1209
Idaho,80-84,528,32089,14969,17120,30224,47,1052,636
Idaho,85+,528,29774,11797,17977,27935,34,949,702
Illinois,0-4,1224,746934,381715,365219,384272,115685,179121,53744
Illinois,5-9,1224,769727,393876,375851,391740,117391,190548,56624
Illinois,10-14,1224,806018,410485,395533,406487,119765,209372,56844
Illinois,15-19,1224,822630,420425,402205,430102,124442,200564,55971
Illinois,20-24,1224,829977,421027,408950,442062,133084,182120,62687
Illinois,25-29,1224,897230,454918,442312,489905,152695,174783,71463
Illinois,30-34,1224,860866,435387,425479,493557,124122,163440,73285
Illinois,35-39,1224,849955,425765,424190,492501,113879,167715,70616
Illinois,40-44,1224,787180,393065,394115,453667,105121,161407,62603
Illinois,45-49,1224,799928,395740,404188,476748,111862,148225,59245
Illinois,50-54,1224,799861,394875,404986,519451,107928,120803,48331
Illinois,55-59,1224,854601,417537,437064,595134,114754,98116,43617
Illinois,60-64,1224,803682,386647,417035,577679,105248,77325,40743
Illinois,65-69,1224,662179,312178,350001,487490,81962,54826,35840
Illinois,70-74,1224,513854,235634,278220,386956,59592,37703,28103
Illinois,75-79,1224,359028,157008,202020,274382,41491,23400,18759
Illinois,80-84,1224,241202,99256,141946,186123,27726,15264,11395
Illinois,85+,1224,266969,91020,175949,214395,26696,15150,9888
Indiana,0-4,1104,418340,214657,203683,293147,47951,46893,21142
Indiana,5-9,1104,431942,221228,210714,302881,48891,49066,21848
Indiana,10-14,1104,447039,228329,218710,312959,50026,54018,20959
Indiana,15-19,1104,457749,234783,222966,329392,49191,48519,22979
Indiana,20-24,1104,472649,241840,230809,344710,50592,41560,29222
Indiana,25-29,1104,464458,235643,228815,344273,55811,36910,22355
Indiana,30-34,1104,426229,213793,212436,322823,47155,34016,18781
Indiana,35-39,1104,427265,213220,214045,325188,43143,37281,18787
Indiana,40-44,1104,401694,200311,201383,309162,39553,34534,16206
Indiana,45-49,1104,413889,206469,207420,329844,38699,29102,14272
Indiana,50-54,1104,410140,203538,206602,339713,35607,22188,11024
Indiana,55-59,1104,448666,219553,229113,382595,37065,17427,10002
Indiana,60-64,1104,426416,206366,220050,369299,33698,13501,8481
Indiana,65-69,1104,358410,170212,188198,315872,25419,9451,6534
Indiana,70-74,1104,278327,128874,149453,249788,17002,6082,4641
Indiana,75-79,1104,191682,84733,106949,173402,11315,3664,2778
Indiana,80-84,1104,126255,52036,74219,114660,7137,2373,1690
Indiana,85+,1104,131069,44775,86294,119274,7120,2768,1436
Iowa,0-4,1188,195636,100071,95565,148017,11595,21136,10693
Iowa,5-9,1188,200156,102321,97835,153009,11246,21112,10662
Iowa,10-14,1188,208339,106578,101761,161328,10758,21850,10478
Iowa,15-19,1188,212204,108821,103383,167736,10371,19827,10916
Iowa,20-24,1188,224211,115535,108676,177406,11509,17942,14401
Iowa,25-29,1188,206055,106783,99272,163469,12246,16133,12099
Iowa,30-34,1188,192095,98161,93934,156078,10129,14466,10151
Iowa,35-39,1188,202273,103019,99254,168122,9169,14354,9528
Iowa,40-44,1188,182942,93178,89764,154275,7408,12524,7835
Iowa,45-49,1188,178216,90013,88203,153707,6453,10614,6691
Iowa,50-54,1188,184293,92596,91697,164024,5449,8741,5502
Iowa,55-59,1188,210834,104130,106704,193990,5087,6731,4490
Iowa,60-64,1188,204862,101085,103777,192026,3961,4831,3572
Iowa,65-69,1188,176886,86486,90400,167734,2823,3291,2682
Iowa,70-74,1188,134561,63773,70788,128483,1835,2075,1906
Iowa,75-79,1188,94817,42981,51836,91247,1061,1165,1178
Iowa,80-84,1188,68016,28608,39408,65669,693,808,729
Iowa,85+,1188,78674,26936,51738,76376,595,950,606
Kansas,0-4,1260,185331,94754,90577,122653,11833,34305,11592
Kansas,5-9,1260,196363,100324,96039,130367,12287,36707,12121
Kansas,10-14,1260,199903,102351,97552,131560,12222,38323,12472
Kansas,15-19,1260,200494,103814,96680,135252,12324,35539,12892
Kansas,20-24,1260,212319,110821,101498,145320,14469,32218,16352
Kansas,25-29,1260,196221,102368,93853,134953,14657,28647,14979
Kansas,30-34,1260,186701,95293,91408,134386,12588,25141,12407
Kansas,35-39,1260,191430,96694,94736,141669,11540,25481,10871
Kansas,40-44,1260,169599,85883,83716,126020,9968,22703,9487
Kansas,45-49,1260,164064,82270,81794,124979,9411,19384,9043
Kansas,50-54,1260,163897,81807,82090,129853,8942,16481,7590
Kansas,55-59,1260,188632,92286,96346,157627,10065,13143,6689
Kansas,60-64,1260,182873,89116,93757,156768,9218,9918,5956
Kansas,65-69,1260,154491,74347,80144,135713,6621,6887,4563
Kansas,70-74,1260,117745,55846,61899,105025,4465,4570,3207
Kansas,75-79,1260,81312,36463,44849,73075,2894,2869,2118
Kansas,80-84,1260,56261,24043,32218,50967,1986,1845,1219
Kansas,85+,1260,65678,23217,42461,60676,1835,1912,1015
Kentucky,0-4,1440,272610,139914,132696,210652,24885,19329,11533
Kentucky,5-9,1440,276417,142260,134157,214843,25421,18398,11842
Kentucky,10-14,1440,284000,144815,139185,221314,26692,18552,11547
Kentucky,15-19,1440,285907,146601,139306,226690,28780,15321,10355
Kentucky,20-24,1440,297891,153923,143968,238096,31210,14164,10432
Kentucky,25-29,1440,309470,158824,150646,251226,31134,13939,10153
Kentucky,30-34,1440,277910,140426,137484,228365,25081,13497,8953
Kentucky,35-39,1440,280548,139424,141124,232541,24001,13504,8745
Kentucky,40-44,1440,270405,134910,135495,227054,22223,11941,7826
Kentucky,45-49,1440,280688,139548,141140,240739,21690,10145,6910
Kentucky,50-54,1440,282974,139385,143589,247347,20931,7787,5838
Kentucky,55-59,1440,307003,148640,158363,271387,22877,6221,5390
Kentucky,60-64,1440,291286,139186,152100,260519,21186,4198,4351
Kentucky,65-69,1440,248803,117245,131558,225606,16205,2739,3495
Kentucky,70-74,1440,199073,92410,106663,183365,10498,1894,2645
Kentucky,75-79,1440,134492,59566,74926,124532,6586,1138,1727
Kentucky,80-84,1440,86328,36030,50298,79822,4279,850,1020
Kentucky,85+,1440,81868,27922,53946,75365,4220,1089,795
Louisiana,0-4,768,301469,153377,148092,151053,105503,27102,12063
Louisiana,5-9,768,301217,153565,147652,152028,108288,23190,12428
Louisiana,10-14,768,306719,156208,150511,156792,114191,19799,11647
Louisiana,15-19,768,293860,149855,144005,152286,111412,16290,10464
Louisiana,20-24,768,303408,153923,149485,157917,113951,16769,11893
Louisiana,25-29,768,335245,168291,166954,179795,122751,18682,11567
Louisiana,30-34,768,322982,160613,162369,180369,108547,21101,11017
Louisiana,35-39,768,315125,154978,160147,180975,101120,20857,10403
Louisiana,40-44,768,274729,135240,139489,159500,87263,17298,9269
Louisiana,45-49,768,269497,131754,137743,164122,81058,14123,8986
Louisiana,50-54,768,278851,135027,143824,173057,84806,11754,8159
Louisiana,55-59,768,308346,147763,160583,196852,91592,10895,7776
Louisiana,60-64,768,296324,140834,155490,192684,86443,8833,7276
Louisiana,65-69,768,248923,116004,132919,165718,69573,6782,5887
Louisiana,70-74,768,193611,88726,104885,135812,47835,4940,4305
Louisiana,75-79,768,131141,57298,73843,94539,29994,3465,2618
Louisiana,80-84,768,85290,34908,50382,61653,19162,2532,1614
Louisiana,85+,768,82057,28686,53371,60130,17502,2560,1566
Maine,0-4,192,63537,32603,30934,55671,2011,1789,2774
Maine,5-9,192,67424,34499,32925,59028,2150,1999,2834
Maine,10-14,192,72676,37116,35560,64151,2058,2263,2866
Maine,15-19,192,77521,40085,37436,68690,2007,2114,3568
Maine,20-24,192,74616,38159,36457,66336,2338,2031,2887
Maine,25-29,192,81044,41169,39875,73600,1766,2070,2822
Maine,30-34,192,81764,40893,40871,74629,1701,2071,2710
Maine,35-39,192,79165,39161,40004,72400,1534,1950,2704
Maine,40-44,192,74910,36825,38085,69328,1253,1503,2302
Maine,45-49,192,83308,40928,42380,77998,1275,1246,2301
Maine,50-54,192,91422,44511,46911,86820,969,1096,2100
Maine,55-59,192,105917,51464,54453,101534,802,1070,2066
Maine,60-64,192,105643,50737,54906,101829,642,811,1902
Maine,65-69,192,93770,44715,49055,90972,410,581,1475
Maine,70-74,192,75309,36250,39059,73383,244,377,1030
Maine,75-79,192,50062,23140,26922,48741,157,283,694
Maine,80-84,192,32324,13835,18489,31415,149,209,421
Maine,85+,192,33800,12022,21778,33072,88,237,325
Maryland,0-4,288,361937,184485,177452,145054,107446,68919,30958
Maryland,5-9,288,370555,189219,181336,150105,112877,63722,33830
Maryland,10-14,288,377314,192425,184889,156747,118088,57542,35262
Maryland,15-19,288,379915,193302,186613,171130,118234,49095,33110
Maryland,20-24,288,371115,188643,182472,169979,119769,44782,30079
Maryland,25-29,288,412144,207520,204624,186548,140168,45754,34011
Maryland,30-34,288,417105,206091,211014,196008,129711,49934,36867
Maryland,35-39,288,410528,200302,210226,188730,123765,55741,37932
Maryland,40-44,288,371685,181202,190483,166451,114385,51176,36209
Maryland,45-49,288,385774,185831,199943,184138,120960,42323,35137
Maryland,50-54,288,409693,196138,213555,214040,127734,34216,30881
Maryland,55-59,288,431688,206221,225467,244037,128809,27211,28979
Maryland,60-64,288,386831,182540,204291,229833,110102,19473,25409
Maryland,65-69,288,312521,142994,169527,192206,85807,12990,20019
Maryland,70-74,288,249061,112180,136881,160424,63119,8432,15916
Maryland,75-79,288,169952,73746,96206,112564,40585,5138,10834
Maryland,80-84,288,108469,44816,63653,72529,25042,3620,6791
Maryland,85+,288,119393,41210,78183,85258,23666,3754,6177
Massachusetts,0-4,168,357362,182950,174412,206652,32074,76371,34393
Massachusetts,5-9,168,368450,188026,180424,217718,34178,72189,36452
Massachusetts,10-14,168,382585,195108,187477,236099,33561,70251,35303
Massachusetts,15-19,168,449834,225386,224448,291564,36251,72522,42208
Massachusetts,20-24,168,485290,241232,244058,313154,40376,75301,49669
Massachusetts,25-29,168,504506,255851,248655,321792,44187,78462,54463
Massachusetts,30-34,168,489948,244210,245738,321284,40411,70216,53726
Massachusetts,35-39,168,444801,220184,224617,290864,36100,65774,48553
Massachusetts,40-44,168,403572,197481,206091,268323,32978,58193,41191
Massachusetts,45-49,168,429056,207842,221214,305417,31844,50400,38814
Massachusetts,50-54,168,464577,225356,239221,353773,32228,44799,31570
Massachusetts,55-59,168,490961,237581,253380,392677,31219,37228,27795
Massachusetts,60-64,168,452229,215819,236410,373041,26384,27855,23212
Massachusetts,65-69,168,373728,174740,198988,314990,19346,19994,18184
Massachusetts,70-74,168,299577,136731,162846,257636,13556,14732,12777
Massachusetts,75-79,168,202003,88281,113722,174763,8871,9135,8682
Massachusetts,80-84,168,134501,54877,79624,116080,6195,5892,5998
Massachusetts,85+,168,159523,53913,105610,141973,5998,5593,5547
Michigan,0-4,996,566442,289273,277169,373715,96047,46546,36088
Michigan,5-9,996,586325,300782,285543,387244,97069,50824,37372
Michigan,10-14,996,610364,312168,298196,408451,93288,54210,39899
Michigan,15-19,996,644559,328926,315633,443147,95937,51522,41215
Michigan,20-24,996,681766,347852,333914,470606,102891,48402,48273
Michigan,25-29,996,697811,357937,339874,477535,123313,42684,44565
Michigan,30-34,996,613803,310931,302872,440573,91084,37459,38167
Michigan,35-39,996,599328,299321,300007,440247,80499,37332,36019
Michigan,40-44,996,566844,280672,286172,415618,79166,34063,33367
Michigan,45-49,996,612531,301893,310638,455454,89210,30651,32971
Michigan,50-54,996,642148,317148,325000,503529,83235,24679,26993
Michigan,55-59,996,708151,346460,361691,576712,82384,20792,24438
Michigan,60-64,996,691384,333755,357629,571643,80137,16434,20036
Michigan,65-69,996,584379,277980,306399,489714,64215,12246,15771
Michigan,70-74,996,453201,211790,241411,383338,47516,8347,12272
Michigan,75-79,996,313609,141446,172163,269240,29739,5202,8195
Michigan,80-84,996,201076,85275,115801,173709,18344,3366,4870
Michigan,85+,996,213136,74919,138217,184187,20812,3446,3889
Minnesota,0-4,1044,351622,179999,171623,239076,36706,31563,35393
Minnesota,5-9,1044,362846,185594,177252,244046,38947,33070,37891
Minnesota,10-14,1044,369747,188225,181522,251817,36542,34315,37548
Minnesota,15-19,1044,361131,184300,176831,256705,31370,30581,34630
Minnesota,20-24,1044,355929,179553,176376,259506,28603,27113,34432
Minnesota,25-29,1044,378787,195196,183591,273912,33273,25715,40594
Minnesota,30-34,1044,383829,196114,187715,283581,33166,24221,38777
Minnesota,35-39,1044,388815,197051,191764,297830,30352,24144,33073
Minnesota,40-44,1044,336762,171383,165379,262563,23843,21947,25949
Minnesota,45-49,1044,328843,166120,162723,263386,21812,18247,23256
Minnesota,50-54,1044,344518,172431,172087,292033,18327,13775,18723
Minnesota,55-59,1044,390965,194597,196368,346232,16042,10843,16362
Minnesota,60-64,1044,365456,180043,185413,330848,12811,7313,13214
Minnesota,65-69,1044,303676,147721,155955,279384,8554,4921,9947
Minnesota,70-74,1044,227383,108118,119265,211576,5308,3056,6861
Minnesota,75-79,1044,158811,72744,86067,148850,3409,1888,4317
Minnesota,80-84,1044,107902,46615,61287,101921,1887,1152,2709
Minnesota,85+,1044,122610,44007,78603,116883,1669,1266,2514
Mississippi,0-4,984,183478,93187,90291,89471,75632,10279,5397
Mississippi,5-9,984,189377,96334,93043,93642,77495,9860,5697
Mississippi,10-14,984,206282,105273,101009,100521,87417,10026,5831
Mississippi,15-19,984,201350,102782,98568,100749,85215,8099,5376
Mississippi,20-24,984,201517,102207,99310,102252,84892,7469,5417
Mississippi,25-29,984,206989,104027,102962,105197,87934,7640,5070
Mississippi,30-34,984,186758,91553,95205,98416,74652,8167,4719
Mississippi,35-39,984,189068,92312,96756,100659,74337,8845,4454
Mississippi,40-44,984,176686,85188,91498,96548,68458,7316,3789
Mississippi,45-49,984,181833,87453,94380,105290,66334,5822,3803
Mississippi,50-54,984,180207,86890,93317,107034,64600,4678,3340
Mississippi,55-59,984,197314,94170,103144,120674,69010,3612,3470
Mississippi,60-64,984,188597,89030,99567,117098,65009,2772,3178
Mississippi,65-69,984,160611,74191,86420,104180,51741,1847,2390
Mississippi,70-74,984,128344,58871,69473,90507,34422,1471,1586
Mississippi,75-79,984,87629,38105,49524,64476,20922,878,1090
Mississippi,80-84,984,57811,23551,34260,42961,13349,612,697
Mississippi,85+,984,52298,17168,35130,38557,12224,717,594
Missouri,0-4,1380,368080,188582,179498,263452,50702,25933,18971
Missouri,5-9,1380,378425,193865,184560,271876,51466,27288,18856
Missouri,10-14,1380,391115,199629,191486,284150,51352,27665,19158
Missouri,15-19,1380,389671,199768,189903,287754,51472,25115,18534
Missouri,20-24,1380,404798,206380,198418,300175,54107,22748,21831
Missouri,25-29,1380,425414,215492,209922,316187,62890,21557,19625
Missouri,30-34,1380,400473,200403,200070,307308,50976,20454,18099
Missouri,35-39,1380,397045,197567,199478,310833,46095,20343,16584
Missouri,40-44,1380,356694,177450,179244,280574,41403,17565,14602
Missouri,45-49,1380,363465,179500,183965,290617,41618,15125,13724
Missouri,50-54,1380,369479,181689,187790,303099,41308,11730,11318
Missouri,55-59,1380,426445,207837,218608,359571,43756,10182,10754
Missouri,60-64,1380,404287,194145,210142,345046,40073,7779,9390
Missouri,65-69,1380,339706,159440,180266,294916,30380,5447,7490
Missouri,70-74,1380,270459,125081,145378,238376,21510,3776,5703
Missouri,75-79,1380,192141,85963,106178,171017,14253,2381,3681
Missouri,80-84,1380,126200,53177,73023,112523,9201,1668,2273
Missouri,85+,1380,133531,46694,86837,120038,9140,1952,1878
Montana,0-4,672,61156,31274,29882,46667,439,4653,7900
Montana,5-9,672,63876,32825,31051,49199,411,4689,8210
Montana,10-14,672,65429,33709,31720,51254,376,3790,8495
Montana,15-19,672,63955,33160,30795,50948,487,3648,7632
Montana,20-24,672,71936,37975,33961,58559,733,3947,7489
Montana,25-29,672,71677,37234,34443,58724,770,3833,7354
Montana,30-34,672,66709,34023,32686,55631,512,3506,6264
Montana,35-39,672,68697,35313,33384,58719,468,3197,5577
Montana,40-44,672,61098,31176,29922,52890,359,2496,4756
Montana,45-49,672,58389,29688,28701,51260,235,2075,4244
Montana,50-54,672,59411,29665,29746,52878,238,1655,4127
Montana,55-59,672,72968,35658,37310,65947,233,1654,4558
Montana,60-64,672,77040,37357,39683,70814,183,1425,4111
Montana,65-69,672,70670,34895,35775,65918,132,1024,3158
Montana,70-74,672,53961,27058,26903,50733,70,721,2161
Montana,75-79,672,36265,17706,18559,34364,33,417,1255
Montana,80-84,672,22686,10485,12201,21382,68,288,810
Montana,85+,672,22855,8865,13990,21824,19,271,629
Nebraska,0-4,1116,130880,67324,63556,86615,7878,25534,8054
Nebraska,5-9,1116,132357,67776,64581,89598,8041,23987,8030
Nebraska,10-14,1116,133939,68594,65345,92019,7969,23562,7662
Nebraska,15-19,1116,132645,67730,64915,94221,7477,21250,7440
Nebraska,20-24,1116,135551,69628,65923,98508,7783,18868,8472
Nebraska,25-29,1116,129709,67005,62704,94102,8438,17170,8538
Nebraska,30-34,1116,125629,64641,60988,93734,7393,15650,7720
Nebraska,35-39,1116,130004,66368,63636,99876,7037,15622,6559
Nebraska,40-44,1116,113135,57510,55625,87929,5783,13550,5246
Nebraska,45-49,1116,108702,55178,53524,86277,5249,11944,4576
Nebraska,50-54,1116,107106,54083,53023,88141,4878,9773,3837
Nebraska,55-59,1116,123589,61218,62371,107426,4969,7582,3157
Nebraska,60-64,1116,118704,58541,60163,105763,4106,5735,2728
Nebraska,65-69,1116,101570,48869,52701,92555,2856,3797,2099
Nebraska,70-74,1116,77338,36626,40712,71199,2055,2428,1488
Nebraska,75-79,1116,53146,24084,29062,49371,1345,1389,919
Nebraska,80-84,1116,37346,15846,21500,35009,847,893,538
Nebraska,85+,1116,43058,15428,27630,40829,726,911,514
Nevada,0-4,204,185575,94941,90634,63908,20187,75657,18869
Nevada,5-9,204,193050,98856,94194,66576,21075,79140,19636
Nevada,10-14,204,199016,101445,97571,68129,20098,83498,21187
Nevada,15-19,204,182631,94148,88483,63599,18105,76119,19961
Nevada,20-24,204,182587,93617,88970,65465,19216,73023,20389
Nevada,25-29,204,229367,117045,112322,92686,27027,77342,27504
Nevada,30-34,204,223749,114859,108890,98231,23586,70437,27538
Nevada,35-39,204,215201,108985,106216,96476,20843,67555,26942
Nevada,40-44,204,195304,98669,96635,88114,18072,62249,24029
Nevada,45-49,204,200161,100751,99410,96559,18026,58163,25002
Nevada,50-54,204,194067,98563,95504,102372,16952,49885,22880
Nevada,55-59,204,197938,98959,98979,116403,16432,40305,23048
Nevada,60-64,204,185538,90463,95075,118226,14383,30180,21153
Nevada,65-69,204,164209,77967,86242,109782,11678,21861,19617
Nevada,70-74,204,139154,66775,72379,98763,8822,14771,15843
Nevada,75-79,204,93275,44530,48745,67340,5796,9555,10017
Nevada,80-84,204,54518,25606,28912,38868,3576,5929,5822
Nevada,85+,204,44816,18648,26168,32436,2592,4931,4610
New Hampshire,0-4,120,63621,32466,31155,53322,1321,4486,3323
New Hampshire,5-9,120,68738,35327,33411,57588,1470,4636,3803
New Hampshire,10-14,120,74711,38274,36437,62937,1400,5111,3981
New Hampshire,15-19,120,83968,42523,41445,72058,1650,4746,4316
New Hampshire,20-24,120,87906,45094,42812,75623,1798,4833,4622
New Hampshire,25-29,120,87395,45608,41787,75211,1970,5058,4372
New Hampshire,30-34,120,85421,43876,41545,73434,1682,4741,4945
New Hampshire,35-39,120,81390,41060,40330,70603,1516,4350,4360
New Hampshire,40-44,120,75110,37301,37809,65779,1311,3813,3753
New Hampshire,45-49,120,86223,42702,43521,77389,1392,3309,3719
New Hampshire,50-54,120,97050,47961,49089,89478,1313,2785,3072
New Hampshire,55-59,120,110245,53993,56252,103604,1159,2306,2733
New Hampshire,60-64,120,104069,51044,53025,99177,787,1540,2220
New Hampshire,65-69,120,85137,41341,43796,81477,524,1031,1860
New Hampshire,70-74,120,67532,32300,35232,65039,353,715,1263
New Hampshire,75-79,120,43777,20421,23356,42249,188,428,803
New Hampshire,80-84,120,27177,11763,15414,26212,118,307,463
New Hampshire,85+,120,30241,10739,19502,29257,102,394,376
New Jersey,0-4,252,514690,263049,251641,225615,68247,155246,56850
New Jersey,5-9,252,532258,271985,260273,235446,71792,154173,62161
New Jersey,10-14,252,551709,281112,270597,259165,73493,145982,64472
New Jersey,15-19,252,552830,283520,269310,274098,76162,136678,58750
New Jersey,20-24,252,540725,274492,266233,267633,81477,130893,54640
New Jersey,25-29,252,579238,295532,283706,277407,91904,137719,67331
New Jersey,30-34,252,573040,290819,282221,271825,80741,140211,76427
New Jersey,35-39,252,580139,289219,290920,271688,75987,145850,82974
New Jersey,40-44,252,557554,275853,281701,264864,73609,137634,78117
New Jersey,45-49,252,584884,287131,297753,303748,78589,125879,73631
New Jersey,50-54,252,615939,299370,316569,357140,80653,114084,61197
New Jersey,55-59,252,642602,312308,330294,403852,80132,99657,56197
New Jersey,60-64,252,581047,278055,302992,385072,67498,76720,49402
New Jersey,65-69,252,461456,215665,245791,317445,49487,54598,38192
New Jersey,70-74,252,371410,167733,203677,263318,37347,39490,30015
New Jersey,75-79,252,262580,113487,149093,188029,26859,26490,20422
New Jersey,80-84,252,176985,71972,105013,127422,17979,18002,13005
New Jersey,85+,252,203104,69285,133819,157228,16608,17538,11023
New Mexico,0-4,396,120986,61690,59296,29012,2153,73343,14857
New Mexico,5-9,396,132779,67810,64969,31388,2568,79903,17216
New Mexico,10-14,396,139489,70811,68678,32672,2300,84530,18303
New Mexico,15-19,396,138458,70557,67901,33405,2424,83382,17788
New Mexico,20-24,396,140001,72869,67132,37542,3256,80490,17302
New Mexico,25-29,396,145634,75738,69896,43080,3657,77013,20550
New Mexico,30-34,396,138453,71278,67175,44455,2989,71095,18888
New Mexico,35-39,396,135544,68808,66736,44259,2855,71019,16472
New Mexico,40-44,396,119302,59670,59632,39235,2489,62305,14574
New Mexico,45-49,396,117382,57959,59423,41671,2326,58803,13918
New Mexico,50-54,396,118274,57794,60480,46442,2218,55671,13368
New Mexico,55-59,396,137530,66288,71242,62001,2638,58577,13631
New Mexico,60-64,396,135391,63970,71421,68548,2494,51679,11995
New Mexico,65-69,396,123189,57700,65489,69354,2031,41730,9551
New Mexico,70-74,396,101294,47726,53568,59815,1274,32749,7028
New Mexico,75-79,396,67613,31108,36505,40229,863,21665,4605
New Mexico,80-84,396,44101,19633,24468,25053,549,15345,3007
New Mexico,85+,396,41409,16023,25386,24469,499,13643,2642
New York,0-4,744,1127001,576910,550091,523353,167232,293350,119968
New York,5-9,744,1117891,571442,546449,522816,165093,289239,118297
New York,10-14,744,1100705,563068,537637,539547,166476,267629,108589
New York,15-19,744,1175399,597739,577660,601887,177395,264847,114826
New York,20-24,744,1269847,634217,635630,643890,198970,275455,135811
New York,25-29,744,1465003,733350,731653,727898,241343,312260,168276
New York,30-34,744,1402648,703593,699055,715631,211319,297256,166063
New York,35-39,744,1271005,629991,641014,648542,184090,279515,148667
New York,40-44,744,1158956,569181,589775,589260,171506,255539,134181
New York,45-49,744,1196751,583079,613672,641415,176139,240443,131253
New York,50-54,744,1275053,618183,656870,729925,189537,226589,121974
New York,55-59,744,1348846,649259,699587,819340,196685,204178,121819
New York,60-64,744,1248310,594863,653447,794241,171318,166001,110936
New York,65-69,744,1032146,481370,550776,683925,129682,126277,88032
New York,70-74,744,827776,373875,453901,567125,98094,95168,64186
New York,75-79,744,578106,248265,329841,396103,71938,66695,41282
New York,80-84,744,398117,161163,236954,274089,47865,46015,28810
New York,85+,744,460001,158298,301703,336433,49091,44602,28297
North Carolina,0-4,1200,609770,311847,297923,308737,135543,109202,42283
North Carolina,5-9,1200,628866,320135,308731,318676,141156,110273,44626
North Carolina,10-14,1200,665606,339338,326268,345035,152347,110566,43901
North Carolina,15-19,1200,688195,350040,338155,377719,160442,97320,40907
North Carolina,20-24,1200,698865,360724,338141,396874,165510,85610,41008
North Carolina,25-29,1200,733576,370403,363173,424398,181181,75060,44909
North Carolina,30-34,1200,682493,335338,347155,407615,154705,69863,44172
North Carolina,35-39,1200,662260,323077,339183,391975,142223,78424,44282
North Carolina,40-44,1200,641167,311218,329949,383142,138130,75712,39622
North Carolina,45-49,1200,688599,335379,353220,438619,145051,64572,36391
North Carolina,50-54,1200,675468,329291,346177,451199,143105,48561,29259
North Carolina,55-59,1200,703294,337120,366174,490731,147392,36126,25796
North Carolina,60-64,1200,658831,309618,349213,473772,135459,24701,22199
North Carolina,65-69,1200,573844,263475,310369,426465,111279,15975,18113
North Carolina,70-74,1200,472664,215901,256763,368500,79140,10055,13523
North Carolina,75-79,1200,316306,140441,175865,252090,48733,6128,8357
North Carolina,80-84,1200,198886,82151,116735,158866,30677,3832,4886
North Carolina,85+,1200,189394,64768,124626,152689,28536,3850,3736
North Dakota,0-4,636,54101,27791,26310,39485,2823,4343,6189
North Dakota,5-9,636,51031,26024,25007,38058,2338,3608,5922
North Dakota,10-14,636,48464,24792,23672,37232,1739,2838,5676
North Dakota,15-19,636,47181,24397,22784,37407,1601,2389,5000
North Dakota,20-24,636,62216,32813,29403,49750,2534,3330,5796
North Dakota,25-29,636,60286,32557,27729,46692,3271,3647,6027
North Dakota,30-34,636,54285,29471,24814,43182,3086,2811,4757
North Dakota,35-39,636,50829,27059,23770,42058,2193,2303,3914
North Dakota,40-44,636,41747,22094,19653,34823,1531,1759,3366
North Dakota,45-49,636,38692,20114,18578,33155,1136,1288,2899
North Dakota,50-54,636,39507,20190,19317,34728,870,1016,2713
North Dakota,55-59,636,47052,23826,23226,42744,756,853,2512
North Dakota,60-64,636,46826,23582,23244,43619,478,543,2025
North Dakota,65-69,636,38449,19474,18975,36323,283,347,1390
North Dakota,70-74,636,28215,13869,14346,26802,119,181,1029
North Dakota,75-79,636,19589,9189,10400,18798,53,97,589
North Dakota,80-84,636,14779,6271,8508,14269,35,79,358
North Dakota,85+,636,18813,6519,12294,18388,20,100,262
Ohio,0-4,1056,690828,353225,337603,482580,106735,46710,37390
Ohio,5-9,1056,708467,363048,345419,495636,110870,47282,37306
Ohio,10-14,1056,731812,373151,358661,520608,109134,47326,37232
Ohio,15-19,1056,755766,386469,369297,556450,106086,43177,35289
Ohio,20-24,1056,751457,381765,369692,553733,108756,38538,37981
Ohio,25-29,1056,801624,406295,395329,589064,126712,38433,37306
Ohio,30-34,1056,752754,378578,374176,567537,104266,36073,37691
Ohio,35-39,1056,724341,359820,364521,556041,93410,35599,33633
Ohio,40-44,1056,673467,334335,339132,525939,84029,30675,27972
Ohio,45-49,1056,713719,353088,360631,570447,87730,25443,25919
Ohio,50-54,1056,733862,362184,371678,604994,83525,20867,21015
Ohio,55-59,1056,808229,393598,414631,678235,89949,17775,18868
Ohio,60-64,1056,796454,382931,413523,677586,85040,14277,16454
Ohio,65-69,1056,666858,315643,351215,575381,65716,10296,13189
Ohio,70-74,1056,522385,240991,281394,457772,46154,7122,9636
Ohio,75-79,1056,357587,156582,201005,315175,30481,4492,6370
Ohio,80-84,1056,243218,100121,143097,214667,21178,2983,3685
Ohio,85+,1056,256272,88738,167534,227247,21581,3394,3299
Oklahoma,0-4,924,255533,131159,124374,132881,20500,46817,42674
Oklahoma,5-9,924,267907,137058,130849,141045,20974,48964,44322
Oklahoma,10-14,924,270141,137749,132392,143349,20795,47104,46007
Oklahoma,15-19,924,264914,136227,128687,144684,22148,41478,45741
Oklahoma,20-24,924,274648,143280,131368,153915,24815,38463,47672
Oklahoma,25-29,924,279982,143213,136769,165346,25773,35460,44618
Oklahoma,30-34,924,263611,133305,130306,164308,21862,33213,37182
Oklahoma,35-39,924,264742,133163,131579,169010,20298,32290,36540
Oklahoma,40-44,924,233131,117025,116106,151616,17435,26848,31896
Oklahoma,45-49,924,230394,115013,115381,155868,16738,22844,29849
Oklahoma,50-54,924,223142,110832,112310,156914,16096,18884,27009
Oklahoma,55-59,924,252949,123221,129728,186805,17532,15688,28270
Oklahoma,60-64,924,240745,115331,125414,184513,16104,11196,24791
Oklahoma,65-69,924,204145,96366,107779,162038,12251,7309,19310
Oklahoma,70-74,924,163905,75830,88075,133762,8432,5018,14208
Oklahoma,75-79,924,116437,52000,64437,97357,5372,2952,8990
Oklahoma,80-84,924,76482,32653,43829,64784,3318,1829,5422
Oklahoma,85+,924,74163,27233,46930,64193,3015,1753,4190
Oregon,0-4,432,227811,116781,111030,143454,5544,50709,20653
Oregon,5-9,432,242452,124090,118362,153646,6021,54082,21386
Oregon,10-14,432,249084,127423,121661,157209,5806,56858,21857
Oregon,15-19,432,246133,126202,119931,157994,5442,52791,23225
Oregon,20-24,432,264104,134351,129753,172090,6240,50719,28026
Oregon,25-29,432,304531,155577,148954,208398,8160,51574,30108
Oregon,30-34,432,299753,152170,147583,214879,7042,44522,28489
Oregon,35-39,432,297541,149711,147830,217753,6751,42384,26161
Oregon,40-44,432,271171,137377,133794,199903,5508,38950,23125
Oregon,45-49,432,261878,132235,129643,197240,4946,33844,22838
Oregon,50-54,432,248249,124272,123977,195485,4697,26715,18763
Oregon,55-59,432,266713,129641,137072,221420,4577,20706,17421
Oregon,60-64,432,272237,129780,142457,234959,4078,15807,15052
Oregon,65-69,432,258569,122401,136168,229704,3091,10827,13027
Oregon,70-74,432,206029,97626,108403,186036,1976,7340,9267
Oregon,75-79,432,135035,62707,72328,123155,1239,4105,5731
Oregon,80-84,432,81909,36586,45323,74522,832,2457,3630
Oregon,85+,432,84538,31797,52741,77637,660,2457,3346
Pennsylvania,0-4,804,697924,357089,340835,454410,91183,95237,42625
Pennsylvania,5-9,804,726053,371201,354852,470108,98187,96153,46113
Pennsylvania,10-14,804,749587,383679,365908,500232,96432,93013,44917
Pennsylvania,15-19,804,803978,409186,394792,554402,101521,88266,47407
Pennsylvania,20-24,804,799230,406017,393213,551524,106402,83608,47242
Pennsylvania,25-29,804,861372,440810,420562,591629,123668,85528,51599
Pennsylvania,30-34,804,847764,430526,417238,603199,105159,80428,52282
Pennsylvania,35-39,804,791515,397078,394437,574014,88729,75872,47570
Pennsylvania,40-44,804,722224,359573,362651,530333,80233,66099,41236
Pennsylvania,45-49,804,773596,383629,389967,591405,82647,56765,38864
Pennsylvania,50-54,804,830501,408851,421650,661498,84425,48838,32435
Pennsylvania,55-59,804,909697,443069,466628,751069,85960,40834,28799
Pennsylvania,60-64,804,895186,431750,463436,758534,77963,30998,24900
Pennsylvania,65-69,804,755303,358688,396615,651476,60032,21443,20277
Pennsylvania,70-74,804,598790,277273,321517,523860,43068,15752,14641
Pennsylvania,75-79,804,419523,184835,234688,370344,28881,9496,9838
Pennsylvania,80-84,804,287634,118280,169354,255612,19372,6121,5868
Pennsylvania,85+,804,332112,112827,219285,299929,20768,5699,5041
Rhode Island,0-4,60,54521,27866,26655,29614,3977,15766,3891
Rhode Island,5-9,60,54899,28153,26746,30307,4365,15187,3709
Rhode Island,10-14,60,57969,29713,28256,33897,4425,14500,3771
Rhode Island,15-19,60,71154,35392,35762,44450,5245,15371,4742
Rhode Island,20-24,60,75503,38009,37494,48022,5542,15262,5511
Rhode Island,25-29,60,75743,38976,36767,47363,5909,15931,5536
Rhode Island,30-34,60,72470,36727,35743,47667,5161,13604,5254
Rhode Island,35-39,60,66258,33402,32856,43948,4793,12477,4433
Rhode Island,40-44,60,59077,29153,29924,40148,4129,11313,2996
Rhode Island,45-49,60,63926,31034,32892,46548,3965,10186,2795
Rhode Island,50-54,60,71186,34477,36709,54706,3941,9354,2779
Rhode Island,55-59,60,76549,36579,39970,62490,3783,7454,2469
Rhode Island,60-64,60,73060,34797,38263,61519,3457,5630,2133
Rhode Island,65-69,60,59360,28011,31349,51385,2325,3920,1528
Rhode Island,70-74,60,46799,21688,25111,41339,1449,2733,1126
Rhode Island,75-79,60,32019,14068,17951,28523,929,1724,743
Rhode Island,80-84,60,21356,8652,12704,19003,762,1073,466
Rhode Island,85+,60,27512,8978,18534,25002,809,1159,442
South Carolina,0-4,552,292464,149429,143035,158851,83399,31193,12527
South Carolina,5-9,552,306776,155950,150826,166991,89326,30562,13425
South Carolina,10-14,552,323940,164443,159497,174804,97920,31724,13186
South Carolina,15-19,552,324659,165857,158802,185221,95701,26512,12278
South Carolina,20-24,552,330743,170451,160292,190445,98785,23988,13393
South Carolina,25-29,552,353271,175694,177577,206970,107690,22829,12333
South Carolina,30-34,552,329583,161167,168416,200756,92129,23467,10688
South Carolina,35-39,552,319990,155506,164484,194635,86776,25052,11496
South Carolina,40-44,552,300514,145904,154610,186092,80024,22715,9987
South Carolina,45-49,552,318195,153847,164348,207114,81008,18830,9773
South Carolina,50-54,552,322412,154915,167497,214127,83779,14790,8408
South Carolina,55-59,552,349976,165680,184296,240119,89298,11526,7663
South Carolina,60-64,552,339168,157657,181511,238370,84147,8514,6980
South Carolina,65-69,552,309207,140894,168313,225701,70839,6029,5689
South Carolina,70-74,552,261393,121217,140176,200680,51623,4161,4171
South Carolina,75-79,552,173014,78602,94412,135750,31590,2442,2719
South Carolina,80-84,552,101999,43515,58484,79631,19006,1422,1641
South Carolina,85+,552,91410,32411,58999,71285,17302,1362,1150
South Dakota,0-4,792,61167,31383,29784,42355,1819,5122,10469
South Dakota,5-9,792,60934,31280,29654,42504,2175,4903,9936
South Dakota,10-14,792,60732,31137,29595,44074,1625,3575,10115
South Dakota,15-19,792,57734,29779,27955,43221,1249,3118,9096
South Dakota,20-24,792,58930,30575,28355,45030,1583,3095,8290
South Dakota,25-29,792,57986,30615,27371,43944,1945,3142,8222
South Dakota,30-34,792,57078,29724,27354,44117,2468,2870,7068
South Dakota,35-39,792,56899,29598,27301,45735,1834,2843,6070
South Dakota,40-44,792,48965,25212,23753,40283,1215,2062,5024
South Dakota,45-49,792,46641,23816,22825,39067,919,1720,4637
South Dakota,50-54,792,48224,24487,23737,41415,827,1470,4263
South Dakota,55-59,792,58789,29247,29542,52502,616,1164,4242
South Dakota,60-64,792,58709,29238,29471,53823,485,832,3358
South Dakota,65-69,792,52022,25950,26072,48438,342,572,2530
South Dakota,70-74,792,37194,18609,18585,34760,217,415,1697
South Dakota,75-79,792,24442,11416,13026,23130,61,192,975
South Dakota,80-84,792,17228,7453,9775,16429,33,112,586
South Dakota,85+,792,20985,7238,13747,20226,34,144,492
Tennessee,0-4,1140,408605,208823,199782,259338,77328,45277,17809
Tennessee,5-9,1140,413379,211447,201932,263702,79751,44041,17509
Tennessee,10-14,1140,431302,219748,211554,281083,81342,43176,17387
Tennessee,15-19,1140,424280,216471,207809,285837,81304,34388,16374
Tennessee,20-24,1140,444925,225087,219838,304504,88751,29817,16369
Tennessee,25-29,1140,497286,249326,247960,343806,100670,30476,17616
Tennessee,30-34,1140,452370,224241,228129,318776,83751,29537,16904
Tennessee,35-39,1140,435528,214785,220743,310129,75678,31019,15847
Tennessee,40-44,1140,412130,202748,209382,298990,68976,27473,14395
Tennessee,45-49,1140,437995,214901,223094,329799,70569,22223,13255
Tennessee,50-54,1140,433284,212004,221280,335307,68160,16677,11319
Tennessee,55-59,1140,460294,220979,239315,364258,71152,12664,10303
Tennessee,60-64,1140,434403,205260,229143,349346,65204,8941,9119
Tennessee,65-69,1140,373761,174024,199737,308222,50999,5912,7192
Tennessee,70-74,1140,307635,142348,165287,263375,33528,4137,5492
Tennessee,75-79,1140,209230,93726,115504,182542,20157,2461,3296
Tennessee,80-84,1140,130998,54448,76550,114406,12617,1492,1987
Tennessee,85+,1140,121769,41873,79896,106120,11853,1671,1620
Texas,0-4,3048,1990891,1015624,975267,616466,233924,990434,119964
Texas,5-9,3048,2063578,1052719,1010859,645557,238269,1022120,127670
Texas,10-14,3048,2103124,1073413,1029711,654596,253442,1042705,126804
Texas,15-19,3048,2052992,1048188,1004804,663642,252089,999545,116744
Texas,20-24,3048,2002525,1030183,972342,684564,259708,923329,116858
Texas,25-29,3048,2172297,1110855,1061442,782878,303418,924144,144504
Texas,30-34,3048,2104466,1069270,1035196,802892,276910,855055,155112
Texas,35-39,3048,2064852,1040150,1024702,793936,263065,840432,154915
Texas,40-44,3048,1877587,938778,938809,719777,233976,771923,141374
Texas,45-49,3048,1853407,919257,934150,763744,230070,717027,133452
Texas,50-54,3048,1700691,843533,857158,767039,211522,609403,105335
Texas,55-59,3048,1721845,843231,878614,880645,210677,530943,92427
Texas,60-64,3048,1553397,748334,805063,858352,184434,424000,80546
Texas,65-69,3048,1261142,590967,670175,736643,136431,316653,66720
Texas,70-74,3048,983886,456004,527882,610185,92349,228919,48852
Texas,75-79,3048,659344,294498,364846,425663,55837,144463,31165
Texas,80-84,3048,421398,178143,243255,272344,33656,95979,17957
Texas,85+,3048,408459,149555,258904,271851,31833,88504,14820
Utah,0-4,348,247803,127060,120743,177697,3035,46919,15253
Utah,5-9,348,258976,132868,126108,189472,3430,47261,14297
Utah,10-14,348,267985,137940,130045,199034,3378,47169,14078
Utah,15-19,348,253847,129312,124535,188441,3378,43649,14492
Utah,20-24,348,264652,135806,128846,197042,3675,42505,17542
Utah,25-29,348,251376,129179,122197,186373,4504,38905,18491
Utah,30-34,348,220430,111776,108654,165611,3306,33846,15556
Utah,35-39,348,231242,117335,113907,180308,2813,32652,13774
Utah,40-44,348,212211,108090,104121,167563,2225,30285,10768
Utah,45-49,348,176934,89984,86950,138152,1945,26329,9551
Utah,50-54,348,151496,76450,75046,119663,1655,21271,8175
Utah,55-59,348,155508,76536,78972,128883,1549,16749,7689
Utah,60-64,348,147626,72048,75578,126969,1328,12519,6271
Utah,65-69,348,124183,59874,64309,109641,791,8503,4863
Utah,70-74,348,95283,45370,49913,85504,468,5733,3285
Utah,75-79,348,65645,30234,35411,59720,289,3461,2010
Utah,80-84,348,42187,19148,23039,38467,161,2310,1156
Utah,85+,348,38574,15907,22667,35219,126,1985,1157
Vermont,0-4,168,29043,14917,14126,25631,583,889,1354
Vermont,5-9,168,31098,16127,14971,27597,593,931,1376
Vermont,10-14,168,33058,16988,16070,29570,566,909,1329
Vermont,15-19,168,41216,21202,20014,36571,892,1299,1850
Vermont,20-24,168,45430,23324,22106,39962,1084,1452,2409
Vermont,25-29,168,37956,19675,18281,33946,722,1143,1754
Vermont,30-34,168,36452,18373,18079,33105,622,1146,1272
Vermont,35-39,168,37019,18347,18672,33796,549,1045,1321
Vermont,40-44,168,34248,16868,17380,31631,491,795,1087
Vermont,45-49,168,37335,18561,18774,34686,483,650,1285
Vermont,50-54,168,40716,19949,20767,38501,435,532,1016
Vermont,55-59,168,47545,23039,24506,45422,383,553,935
Vermont,60-64,168,47834,23369,24465,45903,296,433,926
Vermont,65-69,168,42003,20282,21721,40563,195,312,730
Vermont,70-74,168,33203,15945,17258,32179,124,268,473
Vermont,75-79,168,21938,10297,11641,21359,49,115,327
Vermont,80-84,168,13458,5893,7565,13129,30,76,159
Vermont,85+,168,14437,5160,9277,13988,55,171,156
Virginia,0-4,1596,505477,258463,247014,263036,99796,80355,46846
Virginia,5-9,1596,514886,263899,250987,272003,101318,75702,50434
Virginia,10-14,1596,525235,268469,256766,279099,104938,73283,53261
Virginia,15-19,1596,541828,274892,266936,301142,111150,66622,50035
Virginia,20-24,1596,571619,296914,274705,325538,118087,67277,49950
Virginia,25-29,1596,601926,307429,294497,340605,132441,64832,54911
Virginia,30-34,1596,588455,296462,291993,339790,117907,66241,57220
Virginia,35-39,1596,581713,290900,290813,332970,111408,71788,59343
Virginia,40-44,1596,530783,262954,267829,304958,99655,65431,55516
Virginia,45-49,1596,547506,270344,277162,332910,100996,55021,53916
Virginia,50-54,1596,552768,269973,282795,354138,107187,44025,43611
Virginia,55-59,1596,584373,284021,300352,393745,112966,35650,38479
Virginia,60-64,1596,530044,252612,277432,367500,100743,25832,33100
Virginia,65-69,1596,440858,206073,234785,317376,77768,16733,26789
Virginia,70-74,1596,361433,166279,195154,273562,54944,10853,20589
Virginia,75-79,1596,246799,110139,136660,189531,35956,6584,13736
Virginia,80-84,1596,155331,65643,89688,119259,22916,4121,8378
Virginia,85+,1596,154485,54791,99694,120742,22050,4072,6884
Washington,0-4,468,456476,234488,221988,253343,21115,97861,65493
Washington,5-9,468,468777,239664,229113,259719,21840,102662,66060
Washington,10-14,468,466994,239170,227824,259326,19998,102864,66713
Washington,15-19,468,448059,228733,219326,257183,18871,90097,66153
Washington,20-24,468,481263,252269,228994,282190,23427,86386,74836
Washington,25-29,468,592596,309307,283289,360884,28483,88839,100500
Washington,30-34,468,579479,298918,280561,364397,27705,79318,96539
Washington,35-39,468,550110,281129,268981,354293,24992,75147,85750
Washington,40-44,468,478031,241925,236106,314586,20906,64429,70365
Washington,45-49,468,467553,235701,231852,320050,19461,55448,66064
Washington,50-54,468,456224,228760,227464,332942,18083,43438,56469
Washington,55-59,468,488428,241117,247311,378220,17766,34742,52639
Washington,60-64,468,471180,228525,242655,378890,15381,25880,46594
Washington,65-69,468,411965,195674,216291,341806,10747,17529,38663
Washington,70-74,468,323559,152573,170986,274862,6939,11872,27668
Washington,75-79,468,210934,97928,113006,181177,3866,7155,17412
Washington,80-84,468,128687,56592,72095,110084,2433,4161,11270
Washington,85+,468,134578,49510,85068,116637,2211,3893,11063
West Virginia,0-4,660,93025,47607,45418,81561,3576,2868,2980
West Virginia,5-9,660,100280,51363,48917,88626,3625,2818,3122
West Virginia,10-14,660,103192,53155,50037,91581,3577,2853,3091
West Virginia,15-19,660,105976,54812,51164,94313,4555,2619,2766
West Virginia,20-24,660,110880,57133,53747,98546,5311,2496,3061
West Virginia,25-29,660,111868,57654,54214,100953,5008,2473,2481
West Virginia,30-34,660,102136,52488,49648,91998,4725,2582,2185
West Virginia,35-39,660,106413,53625,52788,96992,4273,2444,2068
West Virginia,40-44,660,107389,53876,53513,99063,3868,2132,1786
West Virginia,45-49,660,114165,57389,56776,106517,3639,1764,1768
West Virginia,50-54,660,115086,57621,57465,107892,3745,1469,1566
West Virginia,55-59,660,125027,60862,64165,117808,3997,1186,1574
West Virginia,60-64,660,129699,62793,66906,122422,4160,981,1635
West Virginia,65-69,660,119185,57194,61991,113134,3353,832,1439
West Virginia,70-74,660,98138,46933,51205,93826,2253,587,1146
West Virginia,75-79,660,65706,30116,35590,62861,1394,388,804
West Virginia,80-84,660,43846,18854,24992,42038,895,288,439
West Virginia,85+,660,40136,14295,25841,38381,821,382,366
Wisconsin,0-4,864,330496,168701,161795,229782,30880,40019,22968
Wisconsin,5-9,864,347240,177736,169504,241326,31191,42480,25156
Wisconsin,10-14,864,366791,187556,179235,257369,31496,45903,24724
Wisconsin,15-19,864,377568,192751,184817,277137,29861,41389,23117
Wisconsin,20-24,864,390572,198773,191799,293784,30715,34859,26283
Wisconsin,25-29,864,379644,195545,184099,282030,34719,31514,27327
Wisconsin,30-34,864,361578,184962,176616,276705,27616,30049,24409
Wisconsin,35-39,864,373501,188602,184899,293593,24934,31429,21074
Wisconsin,40-44,864,339574,172101,167473,271215,21647,28453,16349
Wisconsin,45-49,864,342984,172582,170402,281879,21550,23814,14170
Wisconsin,50-54,864,372225,186105,186120,320158,19779,18400,12529
Wisconsin,55-59,864,422240,208601,213639,375644,19543,14748,11085
Wisconsin,60-64,864,400778,197840,202938,362748,16640,11118,9241
Wisconsin,65-69,864,338616,165387,173229,310983,12372,7415,7133
Wisconsin,70-74,864,256132,123090,133042,237640,8147,4899,4934
Wisconsin,75-79,864,175288,80196,95092,163974,5008,2868,3101
Wisconsin,80-84,864,118898,51385,67513,111450,3373,1851,1981
Wisconsin,85+,864,128309,45296,83013,121648,2802,2000,1601
Wyoming,0-4,276,34931,18104,16827,26234,479,5525,1989
Wyoming,5-9,276,37296,19123,18173,28304,460,5813,2074
Wyoming,10-14,276,39438,20264,19174,30688,405,5679,2096
Wyoming,15-19,276,36507,19058,17449,28678,422,5023,1925
Wyoming,20-24,276,38083,20149,17934,29633,674,4756,2435
Wyoming,25-29,276,38041,19708,18333,30363,651,4472,2124
Wyoming,30-34,276,38392,19967,18425,31474,526,4321,1781
Wyoming,35-39,276,39748,20537,19211,32916,532,4542,1527
Wyoming,40-44,276,34537,17945,16592,29042,408,3583,1283
Wyoming,45-49,276,32452,16807,15645,27550,322,3119,1269
Wyoming,50-54,276,31401,15997,15404,27343,278,2447,1152
Wyoming,55-59,276,38268,19086,19182,34041,357,2578,1097
Wyoming,60-64,276,40486,20225,20261,36787,378,2140,1018
Wyoming,65-69,276,34802,17616,17186,31846,262,1684,880
Wyoming,70-74,276,25788,13003,12785,23691,201,1236,583
Wyoming,75-79,276,16949,8135,8814,15726,59,740,356
Wyoming,80-84,276,10649,4878,5771,9851,51,491,219
Wyoming,85+,276,10991,4128,6863,10213,55,460,221
